###########;
#*********#;
#*@*@*@*@*#;
#*********#;
#*@*@*@*@*#;
#*********#;
#*@*@*@*@*#;
#*********#;
#*@*@*@*@*#;
#*********#;
###########;