###############;
#*************#;
#*@*@*@*@*@*@*#;
#*************#;
#*@*@*@*@*@*@*#;
#*************#;
#*@*@*@*@*@*@*#;
#*************#;
#*@*@*@*@*@*@*#;
#*************#;
###############;