#########;
#*******#;
#*@*@*@*#;
#*******#;
#*@*@*@*#;
#*******#;
#*@*@*@*#;
#*******#;
#*@*@*@*#;
#*******#;
#########;